Explore what you can do with Google Nest or Home devices - Google Nest Help   Skip to main content   Google Nest HelpSign inGoogle HelpHelp CenterSpeakers and DisplaysNest ThermostatCameras and DoorbellLocks and Alarm SystemsSmoke AlarmsWi-FiSubscriptions and ServicesYour privacyCommunityGoogle NestPrivacy PolicyTerms of ServiceSubmit feedback Send feedback on...This help content & informationGeneral Help Center experienceNextHelp CenterCommunityGoogle NestSpeakers and DisplaysGet startedExplore featuresChange your settingsTroubleshoot an issueWarranty, manual and returnsNest ThermostatIntroducing Nest thermostatsGet startedExplore features and settings Fix a problemWarranty, manual & returnsCameras and DoorbellIntroducing Nest cameras and doorbellsGet startedExplore features and settingsFix a problemWarranty, manual & returnsLocks and Alarm SystemsLocksAlarm SystemsSmoke AlarmsIntroducing Nest ProtectGet startedExplore features and settings Safety and certifications Fix a problemWarranty, manual & returnsWi-FiLearn about Wifi productsGet startedFeatures and settingsFix a problemWarranty, manual & returnsYour privacySubscriptions and ServicesNest AwareNest RenewRush Hour RewardsHVAC monitoringNest Pro installationADTYour privacyWarranty, manual and returnsExplore what you can do with Google Nest or Home devices   To get the most out of Google Home, choose your Help Center: U.S. Help Center, U.K Help Center, Canada Help Center, Australia Help Center. 
           Explore what you can do with Google Nest or Home devicesGoogle Nest or Home speakers or displays make life easier by helping you do things like access media, manage your tasks, and plan your day using only your voice.

 Watch or listen to media
Voice Match — Share your speakers or displays with family and friends. Link your Google Account and voice to your speaker or display to get personalized info.
Music — Play music from popular music services by artist, song, genre, album, playlist, mood or activity.
News — Get the latest news from sources you trust.
Watch news — Watch the news on any voice-supported TV with Chromecast or Chromecast built-in.
Podcasts — Listen to popular podcasts.
Radio — Listen to popular radio stations.
Relax — Listen to soothing ambient sounds.
Bluetooth — Play your stored music using Bluetooth.
Audiobooks — Listen to audiobooks from Google Play Books on your speaker or display.
 Control TVs and speakers
Play TV shows and movies — Stream video content to any TV that has Chromecast plugged in or built-in.
Play YouTube videos on TVs — Initiate and control YouTube videos to any TV with Chromecast or Chromecast built-in using only your voice.
View Google Photos (US only) — Enjoy a slideshow of your personal photos from your Google Photos library on any voice-supported TV with Chromecast or Chromecast built-in.
Play audio on speakers and TVs — Stream audio to any speaker that has Chromecast Audio plugged in or Chromecast built-in.
Multi-room audio — Group any combination of speakers and displays, or Chromecast Audio with Chromecast Audio built-in together for synchronous music throughout the home.
Play audio from your phone to the speaker or display — Play audio from your phone to your speaker or display from 100+ Chromecast-enabled audio apps or by playing your Android Audio. 
Turn TV on and off — You can turn your TV on and off using your voice and your speaker or display.
Play YouTube TV — Ready to start to watch content with your speaker or display and YouTube TV? Learn how to set up and use YouTube TV with your speaker or display.
Get your weather forecast on your TV — Get your current weather and forecast on your TV with your Google Assistant and Chromecast or a TV with Chromecast built-in.
 Plan your day
Routines — Get a curated daily snippet about your day which includes weather, calendar, commute, reminders and news.
Traffic — Ask for traffic and travel times when you drive, walk or bike.
Local guide — Search for local places and ask for additional information.
Weather — Ask for current weather or forecasts for the week for your home location or any other location.
Calendar — Ask about an event or get your schedule for the day from Google Calendar.
Flight information — Get status updates on your upcoming flight.
Apps for the Google Assistant — Get things done and have some fun on your speaker or display with third-party created apps for the Google Assistant.
 Get things done
Shopping list — Create a shopping list and check what's already on it.
Shop on your speaker or display — Order everyday essentials and buy items on your shopping list with your Google Assistant on your speaker or display.
Cook — Find and make your favorite recipes using step-by-step cooking instructions from your Google Assistant.
Make calls — Call friends, family, and businesses using just your voice and your speaker or display.
Shortcuts — Create faster, easier ways to do your favorite things with your Google Assistant.
Reminders — You can set, ask about and delete reminders on your speaker or display.
Send information from your speaker or display to your phone — Your Google Assistant can send information from your speaker or display to your phone.
Find your phone with your Google Assistant — Never lose your phone again. You can ask your Google Assistant to ring or call your phone.
Ask your Assistant to remember things — Get a little help from your Assistant to remember things.
Broadcast voice messages to your speaker or display — Send a message to everyone in your home by broadcasting messages on all of your speakers or displays.
 Manage tasks
Timer — Set and manage a timer for cooking, game time, laundry, and even sleep.
General and media alarms — Never run late or miss a flight or meeting. You can set and manage alarms with just your voice.
 Get answers
Facts and info — Ask Google what you want to know.
Finance — Ask about current individual stock prices or current points of an index, like the NASDAQ.
Sports — Ask for scores, live updates, or next game date, location, and time.
Calculator — Perform complicated calculations.
Translation — Get translations for words or phrases in supported languages.
Unit conversions — Get unit conversions.
Nutrition — Get nutrition information for ingredients or food.
Dictionary — Get definitions and spellings for words.
 Control your home
Control your smart home devices — Control supported smart home devices like thermostats, plugs lights, and more.
If this, then that (IFTTT) — Control countless online services and third-party smart devices that aren't directly integrated.
Stream your security camera — Keep an eye on what matters when you stream your security camera on your TV using your speaker or display and Chromecast or a TV with Chromecast built-in.
Doorbell — Hear when someone's at your door or stream your video doorbell on your TV using Chromecast or a TV with Chromecast built-in.
 Have fun
Games — Test your knowledge with trivia and games.
Fun — Try various queries to check if your speaker or display has some surprises.

   Was this helpful?How can we improve it?YesNoSubmit      Need more help? Try these next steps:          Ask the Help Community Get answers from community experts      Contact us Tell us more and we’ll help you get there       true    Warranty, manual and returnsWarranty, safety and regulatory informationExplore what you can do with Google Nest or Home devicesGoogle speaker and display firmware versions and release notesFind Google Nest or Home speaker or display's serial numberReturn a Nest device      Have a question? Get an answer from an expert on the Google Home Help Forum.           ©2022 Google   Privacy Policy   Terms of Service     català‎dansk‎Deutsch‎English (Australia)‎English (Canada)‎English (India)‎English (Singapore)‎English (United Kingdom)‎español‎español (Latinoamérica)‎Filipino‎français‎français (Canada)‎Indonesia‎italiano‎Melayu‎Nederlands‎norsk‎português‎português (Brasil)‎suomi‎svenska‎ไทย‎中文（繁體）‎中文（香港）‎日本語‎한국어‎ English‎         Enable Dark Mode   Send feedback on... This help content & information General Help Center experience       SearchClear searchClose searchGoogle appsMain menu                      Search Help Center               true 1633396                                          false 
