


Blogger.com - Create a unique and beautiful blog easily.














































Skip to content




































Sign in


Create your blog








Publish your passions, your way
Create a unique and beautiful blog easily.
Create your blog









































          Choose the perfect design
        

          Create a beautiful blog that fits your style. Choose from a selection of easy-to-use templates â all with flexible layouts and hundreds of background images â or design something new.
        












          Get a domain
        

          Give your blog the perfect home. Get a blogspot.com domain or buy a custom domain with just a few clicks.
        













          Earn money
        

          Get paid for your hard work. Google AdSense can automatically display relevant targeted ads on your blog so that you can earn income by posting about your passion.
        













          Know your audience
        

          Find out which posts are a hit with Bloggerâs built-in analytics. Youâll see where your audience is coming from and what theyâre interested in. You can even connect your blog directly to Google Analytics for a more detailed look.
        

















          Hang onto your memories
        

          Save the moments that matter. Blogger lets you safely store thousands of posts, photos, and more with Google.
        










Join millions of others
Whether sharing your expertise, breaking news, or whateverâs on your mind, youâre in good company on Blogger. Sign up to discover why millions of people have published their passions here.
Create your blog










Help
Help Center
Help Forum
Video Tutorials


Community
Blogger Buzz


Developers
Blogger API
Developer Forum





Terms of Service
Privacy
Content Policy



English
Afrikaans‎
Amharic - á áá­á‎
Arabic - Ø§ÙØ¹Ø±Ø¨ÙØ©‎
Bulgarian - Ð±ÑÐ»Ð³Ð°ÑÑÐºÐ¸‎
Bengali - à¦¬à¦¾à¦à¦²à¦¾‎
Catalan - âªCatalÃ â¬‎
Czech - ÄeÅ¡tina‎
Danish - Dansk‎
German - Deutsch‎
Greek - ÎÎ»Î»Î·Î½Î¹ÎºÎ¬‎
English (United Kingdom)‎
Spanish (Latin America) - EspaÃ±ol (LatinoamÃ©rica)‎
Spanish (Spain) - EspaÃ±ol (EspaÃ±a)‎
Estonian - eesti‎
Basque - euskara‎
Persian - ÙØ§Ø±Ø³Û‎
Finnish - Suomi‎
Filipino‎
French (Canada) - FranÃ§ais (Canada)‎
French (France) - FranÃ§ais (France)‎
Galician - galego‎
Gujarati - àªà«àªàª°àª¾àª¤à«‎
Hindi - à¤¹à¤¿à¤¨à¥à¤¦à¥‎
Croatian - Hrvatski‎
Hungarian - magyar‎
Indonesian - Indonesia‎
Icelandic - Ã­slenska‎
Italian - Italiano‎
Hebrew - ×¢××¨××ª‎
Japanese - æ¥æ¬èª‎
Kannada - à²à²¨à³à²¨à²¡‎
Korean - íêµ­ì´‎
Lithuanian - lietuviÅ³‎
Latvian - latvieÅ¡u‎
Malayalam - à´®à´²à´¯à´¾à´³à´‎
Marathi - à¤®à¤°à¤¾à¤ à¥‎
Malay - Bahasa Melayu‎
Dutch - Nederlands‎
Norwegian - norsk‎
Polish - polski‎
Portuguese (Brazil) - PortuguÃªs (Brasil)‎
Portuguese (Portugal) - portuguÃªs (Portugal)‎
Romanian - romÃ¢nÄ‎
Russian - Ð ÑÑÑÐºÐ¸Ð¹‎
Slovak - SlovenÄina‎
Slovenian - slovenÅ¡Äina‎
Serbian - ÑÑÐ¿ÑÐºÐ¸‎
Swedish - Svenska‎
Swahili - Kiswahili‎
Tamil - à®¤à®®à®¿à®´à¯‎
Telugu - à°¤à±à°²à±à°à±‎
Thai - à¹à¸à¸¢‎
Turkish - TÃ¼rkÃ§e‎
Ukrainian - Ð£ÐºÑÐ°ÑÐ½ÑÑÐºÐ°‎
Urdu - Ø§Ø±Ø¯Ù‎
Vietnamese - Tiáº¿ng Viá»t‎
Chinese (Simplified) - âªç®ä½ä¸­æâ¬‎
Chinese (Hong Kong) - ä¸­æï¼é¦æ¸¯)‎
Chinese (Traditional) - ç¹é«ä¸­æ‎
Zulu - isiZulu‎









